000000000000000000000000000000000000000000111111111111111111111111111111111111000000000000000000000000000000000000000000000
000000000000000000000000000000000000000000100000000000000000000000000000000001000000000000000000000000000000000000000000000
000000000000000000000000000000000000000000100000000000000000000000000000000001000000000000000000000000000000000000000000000
000000000000000000000000000000000000000000100000000000000000000000000000000001000000000000000000000000000000000000000000000
000000000000000000000000000000000000000000100000000000000000000000000000000001000000000000000000000000000000000000000000000
000000000000000000000000000000000000000000100000000000000000000000000000000001000000000000000000000000000000000000000000000
000000000000000000000000000000000000000000100000000000000000000000000000000001000000000000000000000000000000000000000000000
000000000000000000000000000000000000000000100000000000000000000000000000000001000000000000000000000000000000000000000000000
000000000000000000000000000000000000000000100000000000000000000000000000000001000000000000000000000000000000000000000000000
000000000000000000000000000000000000000000100000000000000000000000000000000001000000000000000000000000000000000000000000000
000000000000000000000000000000000000000000100000000000000000000000000000000001000000000000000000000000000000000000000000000
000000000000000000000000000000000000000000111111111111110000000111111111111111000000000000000000000000000000000000000000000
000000000000000000000000000000000000000000111111111111110000000111111111111111000000000000000000000000000000000000000000000
000000000000000000000000000000000000000000111111111111110000000111111111111111000000000000000000000000000000000000000000000
000000000000000000000000000000000000000000111111111111110000000111111111111111000000000000000000000000000000000000000000000
000000000000000000000000000000000000000000111111111111110000000111111111111111000000000000000000000000000000000000000000000
000000000000000000000000000000000000000000111111111111110000000111111111111111000000000000000000000000000000000000000000000
000000000000000000000000000000000000000000111111111111110000000111111111111111000000000000000000000000000000000000000000000
000000000000000000000000000000000000000000111111111111110000000111111111111111000000000000000000000000000000000000000000000
000000000000000000000000000000000000000000111111111111110000000111111111111111000000000000000000000000000000000000000000000
000000000000000000000000000000000000000000111111111111110000000111111111111111000000000000000000000000000000000000000000000
000000000000000000000000000000000000000000111111111111110000000111111111111111000000000000000000000000000000000000000000000
000000000000000000000000000000000000000000111111111111110000000111111111111111000000000000000000000000000000000000000000000
000000000000000000000000000000000000000000111111111111110000000111111111111111000000000000000000000000000000000000000000000
000000000000000000000000000000000000000000111111111111110000000111111111111111000000000000000000000000000000000000000000000
000000000000000000000000000000000000000000111111111111110000000111111111111111000000000000000000000000000000000000000000000
000000000000000000000000000000000000000000111111111111110000000111111111111111000000000000000000000000000000000000000000000
000000000000000000000000000000000000000000111111111111110000000111111111111111000000000000000000000000000000000000000000000
000000000000000000000000000000000000000000111111111111110000000111111111111111000000000000000000000000000000000000000000000
000000000000000000000000000000000000000000111111111111110000000111111111111111000000000000000000000000000000000000000000000
000000000000000000000000000000000000000000111111111111110000000111111111111111000000000000000000000000000000000000000000000
000000000000000000000000000000000000000000111111111111110000000111111111111111000000000000000000000000000000000000000000000
000000000000000000000000000000000000000000111111111111110000000111111111111111000000000000000000000000000000000000000000000
000000000000000000000000000000000000000000111111111111110000000111111111111111000000000000000000000000000000000000000000000
000000000000000000000000000000000000000000111111111111110000000111111111111111000000000000000000000000000000000000000000000